efmy	〈〉	未使用語
iderni	〈〉	未使用語
neyva	〈〉	未使用語
owvos	〈〉	未使用語
yerve	〈〉	未使用語
isea	〈感嘆詞〉	〜したくない
	〈動詞〉	望まない
erlars	〈感嘆詞〉	Hello!こんにちは！
aldeyn	〈感嘆詞〉	あけおめ・新年のあいさつ
wir'bin	〈感嘆詞〉	ありがとう！
eriy	〈感嘆詞〉	いいえ・no
	〈文頭詞〉	いや・そうではく・反対として
walfy'ya	〈感嘆詞〉	おはよう
way'ya	〈感嘆詞〉	こんにちは
Qis	〈感嘆詞〉	こんにちは・Hi
Cirordo	〈感嘆詞〉	さよなら
Cao	〈感嘆詞〉	シャオ！
katass	〈感嘆詞〉	すーきっ?
tein	〈感嘆詞〉	だめ・駄目だ・やめろ
dag	〈感嘆詞〉	ほら・ほれ・それ
cayna	〈感嘆詞〉	よろしく・初めまして・これからよろしく
tuzi	〈疑問詞〉	形容詞を問う
igar	〈疑問詞〉	時制を問う疑問詞
felio	〈疑問詞〉	場所を問う疑問詞・どこ・どこで
lgy	〈疑問詞〉	数詞を問う
hard	〈疑問詞〉	誰が?・何が?・主格の疑問詞
Reus	〈疑問詞〉	特定を問う疑問詞・どれ・どの
cyow	〈疑問詞〉	名称を問う
erDi	〈疑問詞〉	目的語を問う疑問詞・何を・何に
wels	〈疑問詞〉	理由を問う疑問詞・なぜ・なぜに
KeQ	〈形容詞〉	(声が)高い・高音の・つんざく
	〈副詞〉	高く・高音で
TeQ	〈形容詞〉	(声が)低い・低音の
	〈副詞〉	低く・低音で
leyM	〈形容詞〉	（程度などが）高い・傾向のある
alekt	〈形容詞〉	〜でない(強い否定)
nel	〈形容詞〉	〜など・非限定拡大
	〈名詞〉	皆・この場の全員
kyla	〈形容詞〉	あなた
cai	〈形容詞〉	あの・あんな
alQe	〈形容詞〉	ありえない
lyon	〈形容詞〉	いくつかの・some
mois	〈形容詞〉	いびつな・歪な
	〈副詞〉	いびつに・歪に
enta	〈形容詞〉	うるさい・耳障りな
koska	〈形容詞〉	おいしい・美味な
kataCa	〈形容詞〉	おもしろい・滑稽な・喜劇的な
	〈形容詞〉	漫画的な・まんがのような
	〈名詞〉	漫画本・まんが雑誌
vytel	〈形容詞〉	きれいな・清浄な
stiln	〈形容詞〉	さかさまの
	〈名詞〉	逆位
als	〈形容詞〉	その・限定と強調
eriq	〈形容詞〉	そのままの・むき出しの
katty	〈形容詞〉	そのままの・本来の
	〈副詞〉	そのまま・ただただ
trew	〈形容詞〉	チープな・安っぽい
netu	〈形容詞〉	みずぼらしい
milai	〈形容詞〉	悪いこと・悪事
elia	〈形容詞〉	偉大な
jenirt	〈形容詞〉	一番の・第一の
siatia	〈形容詞〉	煙い
beanik	〈形容詞〉	汚い
alrey	〈形容詞〉	汚れた
jatus	〈形容詞〉	横に行く・横になった
gailen	〈形容詞〉	下級の
helsten	〈形容詞〉	下級以下の・底辺の
olka	〈形容詞〉	下品な
far'e	〈形容詞〉	何もかも
	〈副詞〉	完璧に・〜しつくすまで
celuey	〈形容詞〉	華やかな・カラフルな
jorq	〈形容詞〉	怪しい・怪しげな
geRks	〈形容詞〉	絵のように綺麗な・絵画的な
lisk	〈形容詞〉	外からの
jorlisk	〈形容詞〉	外来の外因の
qeta	〈形容詞〉	甘い
envent	〈形容詞〉	簡易な・野外用の
Ceiti	〈形容詞〉	簡単な
deyny	〈形容詞〉	喜ばしい
segn	〈形容詞〉	強い
Kyyn	〈形容詞〉	狂った・気の違った
hazz	〈形容詞〉	凝った・硬い・凝り固まった
korpu	〈形容詞〉	近い・近くの
canorir	〈形容詞〉	近くの・目と鼻の先の
	〈副詞〉	近くに。すぐそばに・ぴったり近くに
qast	〈形容詞〉	空想の
lanjett	〈形容詞〉	空中の
Rlrd	〈形容詞〉	古い・古き・旧い
	〈接尾辞〉	旧〜・古い〜
feltatas	〈形容詞〉	固有の・風土の
oRq	〈形容詞〉	孤独な
lana	〈形容詞〉	後の・尾っぽの・末の
piker	〈形容詞〉	後験的な・後発の
	〈副詞〉	後で・後に
vin	〈形容詞〉	向こう側
Kwikk	〈形容詞〉	広い・十分な
Kon	〈形容詞〉	高位の
cieyni	〈形容詞〉	再びの
Disti	〈形容詞〉	細かい・小さな・微細な
Luirt	〈形容詞〉	三番目の・みっつめの・第三
siatip	〈形容詞〉	傘下にある・庇護下の
	〈名詞〉	傘下のもの・庇護下のもの・部下
yeing	〈形容詞〉	産まれたての・幼い
Cleq	〈形容詞〉	酸っぱい
xarlins	〈形容詞〉	始めの・最初の・原始の
Qyst	〈形容詞〉	次の・順繰りが次の
enoks	〈形容詞〉	次の・続いた先の
	〈名詞〉	次回・次
weeLuon	〈形容詞〉	実行出来る・出来る状態にある
moza	〈形容詞〉	重なった・重層の
onea	〈形容詞〉	出来ない・不可能な
Diqa	〈形容詞〉	小さな・小さい
caqr	〈形容詞〉	少ない
vortlen	〈形容詞〉	上級の・上位の
xiy	〈形容詞〉	新しい
woga	〈形容詞〉	深い・むずむずとする
edinta	〈形容詞〉	真っ赤な・真紅色の
tywar	〈形容詞〉	真ん中の・中央〜
	〈名詞〉	中心・中央
fascilin	〈形容詞〉	身勝手な・わがままな
Qg'ala	〈形容詞〉	辛い・つらい・しんどい
lott	〈形容詞〉	人工的・不自然な
essa	〈形容詞〉	正式な
xleyn	〈形容詞〉	正常な
likka	〈形容詞〉	先験的な
lanZa	〈形容詞〉	川の・河川性の・淡水の
page	〈形容詞〉	全体的な・全般の
	〈副詞〉	全体的に。全般的に
tily	〈形容詞〉	多い・たくさんの
gordi	〈形容詞〉	大きな・大きい
tilbs	〈形容詞〉	大事ではない・不必要な
wio	〈形容詞〉	沢山の・いっぱいの
Cayly	〈形容詞〉	単純な
wanas	〈形容詞〉	単純な
dyr	〈形容詞〉	短い
arlslen	〈形容詞〉	中級の
ady	〈形容詞〉	調子の悪い
teyntaq	〈形容詞〉	捗っている・捗々しい
gulist	〈形容詞〉	怒り
honie	〈形容詞〉	東の・東方の
	〈名詞〉	東・お日様の昇る方向
klanh	〈形容詞〉	等しい・同等の・同じくらいの
yula	〈形容詞〉	透明な・不可視の
skirt	〈形容詞〉	二番目の・ふたつめの・第二
fila	〈形容詞〉	濡れた・濡れている
aCowi'r	〈形容詞〉	廃れた
virKKat	〈形容詞〉	半分の・半端な
	〈名詞〉	半期
Zo'rdU	〈形容詞〉	肥えた
fycw	〈形容詞〉	普段の・特別でない
veliq	〈形容詞〉	法的な・法に定められた
forett	〈形容詞〉	豊かな・富める・繁栄した
Cagna	〈形容詞〉	凡百の
sina	〈形容詞〉	末の
teavis	〈形容詞〉	無駄な
puty'a	〈形容詞〉	無様な・不格好な・滑稽な
tolt	〈形容詞〉	盲目の・見えない
	〈副詞〉	手探りで
vel'ed	〈形容詞〉	野生の
lalu	〈形容詞〉	唯一の
falawn	〈形容詞〉	様々な
KeRw	〈形容詞〉	良い・よい
xelnik	〈形容詞〉	綺麗な・清浄な
Ceniy	〈形容詞〉	綺麗な・美麗な
tritnia	〈後置詞〉	〜してしまう
lea	〈後置詞〉	〜だけの・唯一〜の
	〈副詞〉	〜のみを・〜だけ
yit	〈後置詞〉	〜などと
tete	〈後置詞〉	〜のように
keR	〈後置詞〉	〜日間
po'a	〈後置詞〉	〜年後
lo'a	〈後置詞〉	〜年前
emen	〈接続詞〉	＆・〜と
	〈動詞〉	足す・加算する
seyn	〈接続詞〉	〜したら・〜したとき
	〈文頭詞〉	その時
fain	〈接続詞〉	〜だから〜せよ
peste	〈接続詞〉	〜であり〜でもある・並列同時同等の接続詞
	〈接続詞〉	〜でなくて〜である・並列同時異等の接続詞
enmecia	〈接続詞〉	〜と〜・＆
em	〈接続詞〉	〜と〜・&
haRo	〈接続詞〉	〜と〜る・that
	〈代名詞〉	関係代名詞・〜な〜とは
sea	〈接続詞〉	〜と・相対・目的としての並列
sai	〈接続詞〉	〜と同じ〜
rurz	〈接続詞〉	〜と比べて・than
eq'anu	〈接続詞〉	〜ならば
vyuq	〈接続詞〉	〜のような
walir	〈接続詞〉	〜のような・装飾
tai	〈接尾辞〉	〜か・弱化・失意・残念の接尾辞
na	〈接尾辞〉	〜が・主格の前置詞
us	〈接尾辞〉	〜させる・使役の接尾辞
wo	〈接尾辞〉	〜させる・他動詞化
el	〈接尾辞〉	〜される・受動・受身
art	〈接尾辞〉	〜さん・敬称の接尾辞
bef	〈接尾辞〉	〜しそう・未然の活用
ly	〈接尾辞〉	〜した・〜しきる・完了
piw	〈接尾辞〉	〜した・動詞状態
biz	〈接尾辞〉	〜したい・願望・希望の接尾辞
i'r	〈接尾辞〉	〜したい・希望の接尾辞
es	〈接尾辞〉	〜したことがある・経験の活用
ania	〈接尾辞〉	〜しちゃった・してしまった・残念失意の接尾辞
uR	〈接尾辞〉	〜している・進行
eta	〈接尾辞〉	〜してくれ・〜するといい
est	〈接尾辞〉	〜してくれ・依頼
oy	〈接尾辞〉	〜してもよい・許可
alu	〈接尾辞〉	〜してもらう・受益の接尾辞
owl	〈接尾辞〉	〜しない・反転の接尾辞
is	〈接尾辞〉	〜しよう・勧誘
a	〈接尾辞〉	〜しろ・命令
akt	〈接尾辞〉	〜しろ・命令
an	〈接尾辞〉	〜しろ・命令
em	〈接尾辞〉	〜し始める・開始
uxxe	〈接尾辞〉	〜す・未来
ela	〈接尾辞〉	〜すら
ein	〈接尾辞〉	〜するな・禁止の接尾辞
xel	〈接尾辞〉	〜するべき・義務
ink	〈接尾辞〉	〜する事・動名詞
	〈接尾辞〉	〜す・動形容詞
Ragi	〈接尾辞〉	〜する者・〜者
iq	〈接尾辞〉	〜だった・過去の接尾辞
or	〈接尾辞〉	〜だろう・予想未来
yur	〈接尾辞〉	〜っていく・緩い進行の接尾辞
ed	〈接尾辞〉	〜て〜・連用
ok	〈接尾辞〉	〜ている・普段
	〈接尾辞〉	〜ている・継続
on	〈接尾辞〉	〜できる・可能の接尾辞
ol	〈接尾辞〉	〜でしょう・〜ですよね・形容の尊敬
mu	〈接尾辞〉	〜でない・非〜
ea	〈接尾辞〉	〜ない・否定の活用
	〈感嘆詞〉	ちがう
aca	〈接尾辞〉	〜な人
alpen	〈接尾辞〉	〜によって・〜に対して
gio	〈接尾辞〉	〜による
uks	〈接尾辞〉	〜の・名詞化の接尾辞
jir	〈接尾辞〉	〜のような・装飾・形容詞化
	〈接尾辞〉	〜らしい・〜に似合う
Kr	〈接尾辞〉	〜の持つ・所有・属格の接尾辞
ek	〈接尾辞〉	〜る・自動詞化
ain	〈接尾辞〉	〜る・動詞化
un	〈接尾辞〉	〜を・対称格
renz	〈接尾辞〉	〜学
	〈名詞〉	(くだけて)学問
pakCi	〈接尾辞〉	〜機・〜機械
pio	〈接尾辞〉	〜群
aj	〈接尾辞〉	〜事・動名詞
Qen	〈接尾辞〉	〜質
bakt	〈接尾辞〉	〜諸君・〜等よ
aM	〈接尾辞〉	〜人・〜の人々〜の者
pa	〈接尾辞〉	〜達・複数の接尾辞
ban	〈接尾辞〉	〜土・〜質土
xyk	〈接尾辞〉	〜番目・序数
	〈動詞〉	安定する
	〈形容詞〉	安定した・定まれり
aaz	〈接尾辞〉	〜風の・〜による
of	〈接尾辞〉	〜用の・目的
kyar	〈接尾辞〉	あなたの・二人称属格
lakr	〈接尾辞〉	あなたの・二人称属格
ta	〈接尾辞〉	強調の接尾辞
kia	〈接尾辞〉	形容詞・副詞の名詞化・~品・〜もの
ti	〈接尾辞〉	指小辞・〜ちゃん
ian	〈接尾辞〉	職人・〜者
os	〈接尾辞〉	生物の接尾辞
et	〈前置詞〉	〜から〜まで
rik	〈前置詞〉	〜から・〜より
	〈前置詞〉	〜の・〜産
Ken	〈前置詞〉	〜して・〜と・理由
ves	〈前置詞〉	〜する前に
luy	〈前置詞〉	〜だけを・限定の前置詞
emenca	〈前置詞〉	〜と〜・＆
go	〈前置詞〉	〜として・as
ot	〈前置詞〉	〜に・in・於
dlxa	〈前置詞〉	〜にとって・〜に於いて
eype	〈前置詞〉	〜によって・〜に対して
tun	〈前置詞〉	〜に沿って・〜のままの
tia	〈前置詞〉	〜の・of・所属・〜内
	〈動詞〉	〜に所属する・〜中にある
lo	〈前置詞〉	〜のために・for
	〈前置詞〉	(主に宛名で)〜へ・(本・書類の表題で)〜の
mi	〈前置詞〉	〜のたもと
ete	〈前置詞〉	〜の中で・in
tang	〈前置詞〉	〜ばかりを
ererl	〈前置詞〉	〜より・by・手段
ped	〈前置詞〉	〜を
win	〈前置詞〉	〜を含む・with
albe	〈前置詞〉	〜程の・about
Kil	〈前置詞〉	〜毎に・〜する度に
sa	〈前置詞〉	on・〜に乗って
bo	〈前置詞〉	or・also・または
rib	〈前置詞〉	to・〜に向かって・〜へ
ye	〈前置詞〉	共に・一緒くたに・〜につれて
la	〈前置詞〉	強調の冠詞的前置詞
ols	〈前置詞〉	時間的な於・〜に
Xine	〈代名詞〉	あそこ・(指を指して)そこ
ais	〈代名詞〉	あたし・私
egqsse	〈代名詞〉	あなたのもの
caixe	〈代名詞〉	あの人
esse	〈代名詞〉	あれ
	〈形容詞〉	あの
isse	〈代名詞〉	あれ・とあるもの・伝聞上のあれ・かの
	〈形容詞〉	あの・とある・伝聞上の
os	〈代名詞〉	これ
osse	〈代名詞〉	これ
	〈形容詞〉	この
azqi	〈代名詞〉	こんな
	〈形容詞〉	このような
	〈副詞〉	このように
lirse	〈代名詞〉	それ
asse	〈代名詞〉	それ
	〈形容詞〉	その
yezqi	〈代名詞〉	そんな
	〈形容詞〉	そのような
	〈副詞〉	そんなに
lente	〈代名詞〉	そんな事・そう
	〈形容詞〉	そのような
	〈副詞〉	このように
yuta	〈代名詞〉	何か
tew	〈代名詞〉	貴方・君・そちら
wey	〈代名詞〉	私(ワタクシ)
we	〈代名詞〉	私・我・わたし
wa	〈代名詞〉	私達・うちら・こっち
niy'yei	〈代名詞〉	誰・だれ
qursse	〈代名詞〉	誰が・誰もが
Qeince	〈代名詞〉	誰かが・誰かを
Qaise	〈代名詞〉	誰も・ただ一人として〜ない
yenk	〈代名詞〉	奴・あいつ・あんにゃろ
caluk	〈代名詞〉	彼
lar	〈代名詞〉	彼・彼女・彼奴
cerla	〈代名詞〉	彼女
lay	〈代名詞〉	僕・私め
kxe	〈単位〉	〜日後
kni	〈単位〉	〜日前
Zua	〈単位〉	〜歩
dana	〈単位〉	111.25mm
Cari	〈単位〉	22.5mm
cator	〈単位〉	445mm
delk	〈単位〉	デルク
iZd	〈単位〉	バージョン・段階
xakk	〈単位〉	歳
	〈名詞〉	歳・年・トシ
kukk	〈単位〉	時
	〈名詞〉	一時間
gal	〈単位〉	出温度
eCrgin	〈単位〉	段階・フェーズ・状態
cykk	〈単位〉	日
	〈名詞〉	一日
vakk	〈単位〉	秒
nakk	〈単位〉	分
tikti	〈動詞〉	(やさしく)叩く・殺傷傷害の意図なく叩く
vaxi	〈動詞〉	(家などに)帰る
bens	〈動詞〉	(花等が)散る
libas	〈動詞〉	(眼に・目に)水や液体が染みて痛む
vely	〈動詞〉	(故意に)破壊する・壊す
meti	〈動詞〉	(数値を)加算する・加える
alged	〈動詞〉	(罰や暴力などを)受ける
xylvis	〈動詞〉	(物理的に)安定する
wal	〈動詞〉	〜する・代動詞・Do
fiexx	〈動詞〉	〜とみられる
banTin	〈動詞〉	〜のふりをする
Zank	〈動詞〉	〜の対になる・対に据えられる
lot	〈動詞〉	〜は・be
	〈接続詞〉	等位
hakkum	〈動詞〉	あげる・融通する・寄付する
qio	〈動詞〉	ある・存在する・いる・在る
sites	〈動詞〉	いなくなる・去る
booz	〈動詞〉	ガッカリとさせる・失望させる・(期待を)裏切る
kyenin	〈動詞〉	コイントスする・賭けにて決める
ozkLus	〈動詞〉	ジャンプする・飛び越える・跳ぶ
two	〈動詞〉	する・行う・Do
banQal	〈動詞〉	なかったことにする・消す・削除する
dent'ail	〈動詞〉	なくなる失われる無くす
yurkeim	〈動詞〉	のたうつ
gesti	〈動詞〉	のどにものを詰まらせる・むせる
klvaQ	〈動詞〉	ふざける・からかう・遊ぶ
pgada	〈動詞〉	愛する・好く・すき・好きである
dikata	〈動詞〉	逢う・会合する・会う
aguli	〈動詞〉	一寸にする・遠慮する
jala	〈動詞〉	飲む
Katain	〈動詞〉	嘘をつく
jestin	〈動詞〉	遠慮する・躊躇する・思いとどまる
Cxin	〈動詞〉	歌う
stey'yen	〈動詞〉	過ぎる
xaenk	〈動詞〉	介入する・手を出す・口出す
leyz	〈動詞〉	回転する・回る
pal	〈動詞〉	開ける
icno	〈動詞〉	革命する・大きく変わる・様変わる・打ち倒す
	〈名詞〉	革命
misrote	〈動詞〉	叶う・実現する
ekatt	〈動詞〉	完成する
wirt	〈動詞〉	感じる
bieq	〈動詞〉	感謝する
aklenz	〈動詞〉	感染する
deytam	〈動詞〉	喜ぶ
dey	〈動詞〉	喜ぶ
	〈感嘆詞〉	やったぜ
	〈形容詞〉	喜ばしき・うれしい
Kwosta	〈動詞〉	帰ってくる
Zofcis	〈動詞〉	気付く・見出す・はっとする
iclas	〈動詞〉	記す・記録する
oRga	〈動詞〉	記録する
yiska	〈動詞〉	記録する・録音する
walwo	〈動詞〉	起こる・起きる・おこる
Cente	〈動詞〉	輝く
danbi	〈動詞〉	逆らう・反目する
akCaq	〈動詞〉	救う・助ける
goda	〈動詞〉	求める・望む
ktor	〈動詞〉	泣く・涙を流す
hae	〈動詞〉	居る・居座る・(じっと)留まる
akacoln	〈動詞〉	虚化する
kuliuM	〈動詞〉	協力する
hwote	〈動詞〉	叫ぶ
enaulu	〈動詞〉	教えてもらう
enia	〈動詞〉	教える
Zanta	〈動詞〉	興味を失う・飽きる
amunow	〈動詞〉	苦労する
Kgyw	〈動詞〉	苦労する
fladus	〈動詞〉	掘り出す・発掘する
nasM	〈動詞〉	繰り返す・回す
attyela	〈動詞〉	形容する・修飾する
tante	〈動詞〉	繋ぐ・連結する・結びつける
cirj	〈動詞〉	計算する
maynor	〈動詞〉	警戒する
tuel	〈動詞〉	嫌う
befise	〈動詞〉	嫌になる・音を上げる・あきらめる
Ceyka	〈動詞〉	建てる・建築する
Zofte	〈動詞〉	見つける・見出す
cef	〈動詞〉	見つめる・じっと観測する
jent	〈動詞〉	見る
lapes	〈動詞〉	現れる・顔を出す
meantam	〈動詞〉	言い訳をする
fog	〈動詞〉	言う・伝える
qyn	〈動詞〉	呼ばれる・名される
gena	〈動詞〉	枯れる
genQ	〈動詞〉	工事する・作る・作り替える
akcino	〈動詞〉	更新する・改める
klant	〈動詞〉	絞める
aken	〈動詞〉	考える・希哲する
oRo	〈動詞〉	行く・行軍する・往く
asCu	〈動詞〉	塞ぎ・蓋
Kenir	〈動詞〉	彩る・花を添える
Kenxy	〈動詞〉	裁く・責める・譴責する・けん責する
aklas	〈動詞〉	咲く
jrq	〈動詞〉	作る
Zikka	〈動詞〉	作業する
daam	〈動詞〉	殺す・めためたに壊す
bermo	〈動詞〉	散乱する・散らかる
qem	〈動詞〉	産まれる・生まれる・誕生する
xale	〈動詞〉	斬る
icalur	〈動詞〉	斬る・切断する・絶つ
neeq	〈動詞〉	残す・継承する・(その場にいなくとも)影響を及ぼす
tuRo	〈動詞〉	使う
Diwemo	〈動詞〉	刺す・(悪意を以って生物を)刃物で刺す
xarlo	〈動詞〉	始まる・始める
arqs	〈動詞〉	思い込む
aritto	〈動詞〉	止まる・中止される
suoh	〈動詞〉	止める・やめる
Seno	〈動詞〉	止める・妨げる・邪魔をする
dort	〈動詞〉	死ぬ
yelda	〈動詞〉	死ぬ
Cy'as	〈動詞〉	試みる・やってみる
xik	〈動詞〉	似合う
	〈形容詞〉	似合った・見合った
Zijtes	〈動詞〉	持ち去る・(故意に)持って行く
nanta	〈動詞〉	持つ・所有する
klse	〈動詞〉	自覚する
weera	〈動詞〉	実行する・する・Do
antent	〈動詞〉	写す写生する
	〈形容詞〉	生き写しの
ayn	〈動詞〉	射る
messe	〈動詞〉	主張する
derkente	〈動詞〉	手をつなぐ
azapes	〈動詞〉	手放す・失う
webens	〈動詞〉	終わる
opininis	〈動詞〉	集中を切らす・よそ見をする
	〈動詞〉	怠惰である・さぼる
deytor	〈動詞〉	祝う
elib	〈動詞〉	出会う
xinks	〈動詞〉	出題する
helka	〈動詞〉	書く・記す
cily	〈動詞〉	床・地面
edylot	〈動詞〉	消す・削る
aber	〈動詞〉	笑う・嘲る
CistiM	〈動詞〉	紹介する
xeymeaQ	〈動詞〉	証明する・納得させる
Qazin	〈動詞〉	拭う・拭きとる
carikari	〈動詞〉	殖える・増殖する
tylrx	〈動詞〉	触る
xrdi	〈動詞〉	食べる
swonk	〈動詞〉	信じる・信用する
cyp	〈動詞〉	進む
kor'ey	〈動詞〉	進む・進軍する
nord	〈動詞〉	震える
xarust	〈動詞〉	水が染みこむ・深く濡れる
caj	〈動詞〉	数える・指折り数える
	〈名詞〉	数える・指折り数える
las	〈動詞〉	成す・為す・〜とする
esscl	〈動詞〉	整頓する・掃除する
si'ja	〈動詞〉	生きる
car	〈動詞〉	生み出す・出産する
adelni	〈動詞〉	石打ちする
	〈名詞〉	石打ち
jes	〈動詞〉	切る
Cygena	〈動詞〉	雪枯する・雪がなくなる
lust	〈動詞〉	染みになる・(味が)染みる・しみる
caow	〈動詞〉	走る
lfela	〈動詞〉	増える
iyenmi	〈動詞〉	息をつく・休憩する・ほっとする
yeinad	〈動詞〉	捉える
ayein	〈動詞〉	足す・加算する
oKnak	〈動詞〉	続く
eCu	〈動詞〉	続く・(これから先にも)続いている
Ton	〈動詞〉	存在する
Zorne	〈動詞〉	対応する・(一対一で)結びつく
Satis	〈動詞〉	耐える
satis	〈動詞〉	耐える
hayl	〈動詞〉	待ち構える・張り込む
kint	〈動詞〉	待つ
elq'o	〈動詞〉	貸す
Diko	〈動詞〉	叩く・殴打する・殴る
grus	〈動詞〉	奪う・強奪する
Zbeft	〈動詞〉	探す
wenks	〈動詞〉	弾く
jelen	〈動詞〉	断髪する・髪を切る
iM	〈動詞〉	知る
	〈感嘆詞〉	あぁ。・そうだったのか
pos	〈動詞〉	置く
skrlin	〈動詞〉	喋る・話す・雑談する
sent	〈動詞〉	聴く
oz'ak	〈動詞〉	超える・飛び越える
Nako	〈動詞〉	掴む
fecy	〈動詞〉	貼り付ける・接着する
tuk	〈動詞〉	転がる
enest	〈動詞〉	伝える
gulain	〈動詞〉	怒る
tweek	〈動詞〉	投げる
tawor	〈動詞〉	到達する
font	〈動詞〉	到着する・到達する
Kery	〈動詞〉	討伐する・成敗する・やっつける
ukRe	〈動詞〉	逃げる・逃走する
velin	〈動詞〉	頭に乗せる・(帽子などを)かぶる
	〈接続詞〉	乗せる・乗せた・乗せ
mok	〈動詞〉	働く・はたらく・労働する
wog	〈動詞〉	動く・動かす・動作する
lary	〈動詞〉	突く・衝く
mujas	〈動詞〉	入る・侵入する
moni	〈動詞〉	入浴する・お風呂に入る
sinlaxx	〈動詞〉	年末
Cgy	〈動詞〉	悩む
aCown	〈動詞〉	廃る
yed	〈動詞〉	買う
zay	〈動詞〉	売る・商売する・交換する
hyurZa	〈動詞〉	剥がす・剥ぐ・削ぐ・(獲物などを)解体する
belni	〈動詞〉	拍手をする
alrtai	〈動詞〉	薄汚れた
verent	〈動詞〉	爆破する
veqa	〈動詞〉	爆発する
zyka	〈動詞〉	発音する・読む
esiaty	〈動詞〉	発生する・生えてくる
yaldia	〈動詞〉	抜ける・しなびる
okan	〈動詞〉	判断する
ZofKo	〈動詞〉	判別する・見つける・分かる
waif	〈動詞〉	疲れる
	〈形容詞〉	疲れた
nasvel	〈動詞〉	被る
maace	〈動詞〉	非難する・糾弾する
tyfal	〈動詞〉	必要になる
reyla	〈動詞〉	評価する・採点する
gr'rin	〈動詞〉	描く
jeta	〈動詞〉	風が吹く
	〈形容詞〉	風の強い
meluain	〈動詞〉	風邪をひく
worp	〈動詞〉	覆う・庇護する・保護する・隠す
fwel	〈動詞〉	聞かれる・聞いてもらう
fuo	〈動詞〉	聞く
elence	〈動詞〉	並べる
	〈動詞〉	掛ける・掛け算する
akac	〈動詞〉	変わる・変化する
cekten	〈動詞〉	歩く
noupw	〈動詞〉	包む
denva	〈動詞〉	崩れる
torpol	〈動詞〉	望む・欲する・切望する
miwa	〈動詞〉	満ちている・満ちる
	〈形容詞〉	満ち足りた
tyxen	〈動詞〉	味わう
niha	〈動詞〉	眠る・休息する・睡眠
iprii	〈動詞〉	鳴く
Cilon	〈動詞〉	滅ぼす・抹消する
skr'ro	〈動詞〉	黙る・口を閉じる
fiv	〈動詞〉	戻る・やめる・後退する
hekum	〈動詞〉	貰う・受益する
vote	〈動詞〉	踊る
	〈動詞〉	演ずる
goon	〈動詞〉	欲しがる・欲す
luku	〈動詞〉	落ちる
alke	〈動詞〉	落とす
jeni	〈動詞〉	理解する・了解する・諒解する
	〈感嘆詞〉	そう・はい・yes
siataa	〈動詞〉	立ち尽くす・立ちすくむ・ひるむ
sianti	〈動詞〉	立つ
meyli	〈動詞〉	流れる・滴る・滑り落ちる
galoo	〈動詞〉	冷たくある・冷たい
entiv	〈動詞〉	練習する
etyskks	〈動詞〉	錬金する
ons	〈動詞〉	嗅ぐ
stey	〈副詞〉	〜の目の前で
	〈前置詞〉	〜の目の前で
oztliakks	〈副詞〉	あさってに
	〈名詞〉	あさって・明後日
yekk	〈副詞〉	あの日・その時
jae	〈副詞〉	いつか・そのうち
jar	〈副詞〉	いつかの・いつかに
pay	〈副詞〉	いつも・しょっちゅう
ozty'akks	〈副詞〉	おとといに
	〈名詞〉	おととい・おとつい・一昨日
osni	〈副詞〉	ここで・ここの
osti	〈副詞〉	ここには・ここに(前述の場所を受けて)
nalia	〈副詞〉	ずっと・延々と
canor	〈副詞〉	そばに・近くに
sRlen	〈副詞〉	そろそろ・遠くなく
pal'an	〈副詞〉	とうに・すでに・随分と前に
felir	〈副詞〉	とても
lova	〈副詞〉	とても
lagey	〈副詞〉	また・再び・再度
bast	〈副詞〉	やっぱり・やはり
	〈感嘆詞〉	それみたことか！・ざまぁみろ
akku	〈副詞〉	過去に
	〈名詞〉	過去・経験
soktohye	〈副詞〉	過剰に・無駄に
akozitt	〈副詞〉	確かに・間違いなく
segnq'a	〈副詞〉	強く・強烈に
segta	〈副詞〉	強大な
wis	〈副詞〉	今・ただ今
ilyan	〈副詞〉	今更に
Ceaks	〈副詞〉	今日に
ty'akks	〈副詞〉	昨日に
wilvo	〈副詞〉	思っていたよりも・予想外に
godir	〈副詞〉	自在に・思いのままに・望むままに
	〈形容詞〉	自在な・思いのままの
jorTikk	〈副詞〉	初めて
kaws	〈副詞〉	速く
wiot	〈副詞〉	沢山に・たっぷり・いっぱい
henpty'a	〈副詞〉	短縮して・簡潔に
myjot	〈副詞〉	本気で・真剣に・冗談でなく
pirgekks	〈副詞〉	毎日
kasi	〈副詞〉	未だ・まだ
illa	〈副詞〉	未来
myeise	〈副詞〉	無視して・気にせずに
teavaqty	〈副詞〉	無秩序に・混沌と
	〈形容詞〉	無秩序な・混沌の・乱雑な
tliakks	〈副詞〉	明日に
kap	〈文頭詞〉	〜だから〜だろう
venial	〈文頭詞〉	〜だとしても・しかし
kix	〈文頭詞〉	〜でも・しかし
in	〈文頭詞〉	〜なので
kaste	〈文頭詞〉	〜らしいと聞いた不確定だが
bale	〈文頭詞〉	きっと
felmas	〈文頭詞〉	だから
luen	〈文頭詞〉	たぶん・恐らく・推量
klaste	〈文頭詞〉	また・同時に・さらに
pniaCa	〈文頭詞〉	もしも〜なら・if
bey	〈文頭詞〉	もしも〜なら・if
	〈動詞〉	閉じる
enca	〈文頭詞〉	意外と・案外
ZalaK	〈文頭詞〉	仮定しての・まさか
hel	〈文頭詞〉	疑問の文頭詞
baCCu	〈文頭詞〉	具体的には〜・例を挙げれば〜
post	〈文頭詞〉	次には・話題の発展
kross	〈文頭詞〉	次は〜について〜・話題の転換
selcw	〈文頭詞〉	話は変わるが・そうそう・そういえば
gles	〈名詞〉	!!
Qaul	〈名詞〉	(貫通した)穴
yon	〈名詞〉	(群れた)人・群衆・集団
kpolla	〈名詞〉	(樹性の)果物・果実
banCi	〈名詞〉	(食べられる状態の)食肉
agodo	〈名詞〉	(人間の)大人
dhan'na	〈名詞〉	(装飾された)髭
godos	〈名詞〉	(動物の)大人・成体
hanipola	〈名詞〉	(蔓性・草本性の)果物・果実
javahala	〈名詞〉	(明度の高い)黄色(を発色する染料)
riven'agi	〈名詞〉	(模範となる)人師匠
Coltik	〈名詞〉	(暦の上での)月
reiben	〈名詞〉	(恋愛的な)好きという気持ち
doles	〈名詞〉	.・文頭符・文末符
heles	〈名詞〉	?・疑問の文頭・文末符・疑問符
possikt	〈名詞〉	〜と成す・置く
vala	〈名詞〉	〜の裏
ely	〈名詞〉	0
miye	〈名詞〉	0.00000000001・一測
mije	〈名詞〉	0.0000000001・一挨
mime	〈名詞〉	0.000000001・一塵
miria	〈名詞〉	0.00000001・一沙
miTe	〈名詞〉	0.0000001・一繊
mixx	〈名詞〉	0.000001・微
teye	〈名詞〉	0.00001・一忽
jie	〈名詞〉	0.0001・一糸
mie	〈名詞〉	0.001・一毛
ria	〈名詞〉	0.01・一厘
Te	〈名詞〉	0.1・一分
oln	〈名詞〉	0・ゼロ・零・虚・虚空
	〈形容詞〉	初めの・虚ろな・原初の
ty'a	〈名詞〉	1・一・一つ
	〈形容詞〉	ある一つの・(多くの同じものの中で)たった一つの
Za	〈名詞〉	10・十
	〈形容詞〉	十番目の・十の
fin	〈名詞〉	100・百
sin	〈名詞〉	1000・千
	〈形容詞〉	千の
lame	〈名詞〉	10000・万
	〈形容詞〉	万の
pag	〈名詞〉	100000・十万
	〈形容詞〉	十万の
zipp	〈名詞〉	1000000・百万
	〈形容詞〉	百万の
fipp	〈名詞〉	10000000・千万
	〈形容詞〉	千万の
sipp	〈名詞〉	100000000・億
	〈形容詞〉	一億の
lapp	〈名詞〉	1000000000・十億
	〈形容詞〉	十億の
papa	〈名詞〉	10000000000・百億
	〈形容詞〉	百億の
Ql	〈名詞〉	2・二
	〈形容詞〉	二番目の・二つの
lant	〈名詞〉	3・三
	〈形容詞〉	三番目の・三つの
fyl	〈名詞〉	4・四
	〈形容詞〉	四番目の・四つの
var	〈名詞〉	5・五
	〈形容詞〉	五番目の・五つの
kalr	〈名詞〉	6・六
	〈形容詞〉	六番目の・六つの
sala	〈名詞〉	7・七
	〈形容詞〉	七番目の・七つの
wixa	〈名詞〉	8・八
	〈形容詞〉	八番目の・八つの
Qa	〈名詞〉	9・九
	〈形容詞〉	九番目の・九つの
alte	〈名詞〉	Aa
	〈代名詞〉	一番目・一等
	〈形容詞〉	一番目の・一等の・初めの
belto	〈名詞〉	Bb
caq	〈名詞〉	Cc
derl	〈名詞〉	Dd
elto	〈名詞〉	Ee
fisto	〈名詞〉	Ff
gosten	〈名詞〉	Gg
hist	〈名詞〉	Hh
ilto	〈名詞〉	Ii
jerte	〈名詞〉	Jj
karon	〈名詞〉	Kk
lulto	〈名詞〉	Ll
mesty	〈名詞〉	Mm
nayuto	〈名詞〉	Nn
olto	〈名詞〉	Oo
pesto	〈名詞〉	Pp
Qanto	〈名詞〉	Qq
rast	〈名詞〉	Rr
san	〈名詞〉	Ss
tist	〈名詞〉	Tt
ulto	〈名詞〉	Uu
valM	〈名詞〉	Vv
wla	〈名詞〉	Ww
xesten	〈名詞〉	Xx
yalto	〈名詞〉	Yy
zel	〈名詞〉	Z・z
	〈代名詞〉	二番目・二等
	〈形容詞〉	二番目の・二等の
hyati	〈名詞〉	あいらしい・かわいい
deR'onta	〈名詞〉	あっち向いてほい
andas-teskra	〈名詞〉	アンデス・テスクラ神
Kai	〈名詞〉	インク・墨汁
	〈動詞〉	塗る・(びっしりと)書く・描く
mea	〈名詞〉	ウマ・馬
	〈名詞〉	オオネズミ
tivloxxa	〈名詞〉	うるう年・閏年
etilkata	〈名詞〉	エティルカータ地方
ete	〈名詞〉	エテ地方・得圏
acmur'a	〈名詞〉	おじいさん・祖父
zakala	〈名詞〉	お菓子・おかし・おやつ
riven	〈名詞〉	お手本
	〈形容詞〉	模範的な・規範的な
jan'as	〈名詞〉	お茶
mazo	〈名詞〉	お腹・腹部
pskaCakla	〈名詞〉	お野菜
latahangdiaRas	〈名詞〉	カメラ
kanta	〈名詞〉	カンタ神
kolbens	〈名詞〉	キャンバス
aklante	〈名詞〉	ギルド・同業者集団・座
nass	〈名詞〉	くぼみ・(底のある)穴
xavalin	〈名詞〉	クリーム・ムース
tit'Ci	〈名詞〉	ケバブ的出料理
Cel	〈名詞〉	シェル暦・出暦
Sabqtt	〈名詞〉	シャーバの置閠法・シャーバ暦・シャーバ改暦
wakb	〈名詞〉	スカート・腰蓑・こしみの
asikk	〈名詞〉	スプーン・匙
ragistpinCi	〈名詞〉	スプレー・散布機
dandil	〈名詞〉	スポーツ・身体競技
weelin	〈名詞〉	するべきこと
xenpanziy	〈名詞〉	チンパンジー
ceka	〈名詞〉	つやのある黒・黒いもの
derle	〈名詞〉	デーレ・出圏・出国・出界・出語・出人
yoyos	〈名詞〉	とかげ
tolu'e	〈名詞〉	トルエ地方・取圏
qr'a	〈名詞〉	ニーア
	〈単位〉	ニーア
alley	〈名詞〉	ネズミ・鼠
lisZelt	〈名詞〉	ノート・メモ・手帳
baamina	〈名詞〉	バーミナ神
baaraca	〈名詞〉	バーラシャ神・日曜日・日曜神
baaranCia	〈名詞〉	バーランシャ神・バラジャ神
jelwsada	〈名詞〉	ハサミ・鋏
tios	〈名詞〉	パン・小麦の発酵焼き
k'wiska	〈名詞〉	ビデオゲーム・(道具を用いた)遊び・遊戯
leyztans	〈名詞〉	ぶらんこ・ブランコ
elhest	〈名詞〉	ヘリウム
valtin	〈名詞〉	ベリリウム
eni	〈名詞〉	ペン
menitin	〈名詞〉	マグネシウム
ceyZaM	〈名詞〉	メロディー・旋律
kanam	〈名詞〉	メンバー・成員・員
ravien	〈名詞〉	ラヴィエン地方・羅圏
meyZal	〈名詞〉	リズム・拍
Linkty	〈名詞〉	リチウム
lstaka	〈名詞〉	ルスタカ神
lty	〈名詞〉	ルティ地方
	〈名詞〉	純血主義者
ty'yoZos	〈名詞〉	ワニ・わに・鰐
evorle	〈名詞〉	亜人
raiten	〈名詞〉	愛情・愛
efty	〈名詞〉	意味
	〈動詞〉	意味する
kes'ad	〈名詞〉	椅子・いす
zelo	〈名詞〉	違い
tusu	〈名詞〉	井戸・水源
ifoll	〈名詞〉	一覧・表
hal	〈名詞〉	右
	〈形容詞〉	右側の
tuos	〈名詞〉	雨が降っている様・雨降り
xila	〈名詞〉	雨粒・あめ
Kat	〈名詞〉	嘘
lmbyaadeyn	〈名詞〉	閏日
ksQos	〈名詞〉	雲・くも
myaf	〈名詞〉	円・まる・丸
funi	〈名詞〉	炎
siatto	〈名詞〉	煙
lamusgy	〈名詞〉	王・領主
jinka	〈名詞〉	黄色
lanCu	〈名詞〉	屋根・天蓋
soff	〈名詞〉	音・物音・聴覚刺激
ceyM	〈名詞〉	音楽
CaM	〈名詞〉	音素・発音
Nels	〈名詞〉	仮面
yeljetto	〈名詞〉	夏
Cykaka	〈名詞〉	家屋・(居住性のある)建物
mani	〈名詞〉	家畜乳・牛乳
lnsa	〈名詞〉	花
gulast	〈名詞〉	課題・宿題
pyenas	〈名詞〉	海洋・海
gisti	〈名詞〉	絵・絵画
oBil	〈名詞〉	階・階層
uens	〈名詞〉	外側・見知らぬところ
baa	〈名詞〉	外来神の接頭語
hil	〈名詞〉	学校
hillakanza	〈名詞〉	学校・教育施設
xalk	〈名詞〉	学年・grade
misrotas	〈名詞〉	叶わぬこと・絵に描いた餅・実現不能な夢
pataCa	〈名詞〉	鞄・かばん・手提げバッグ
Komitto	〈名詞〉	感情
inqsse	〈名詞〉	観衆・その他大勢
	〈代名詞〉	有象無象
Qea	〈名詞〉	間違い・ミス
jerxe	〈名詞〉	眼・瞳孔
dio	〈名詞〉	眼鏡・めがね
thocii	〈名詞〉	顔面
cadi	〈名詞〉	机
yente	〈名詞〉	机
meceek	〈名詞〉	期間・頃・時期
lt	〈名詞〉	記号
pilla	〈名詞〉	記事・頁・章・編
xayl	〈名詞〉	弓
akluks	〈名詞〉	虚化した者
olnin	〈名詞〉	虚閃
	〈動詞〉	虚閃を放つ
jor'laM	〈名詞〉	虚像・嘘の事
olNes	〈名詞〉	虚面
yo	〈名詞〉	魚・ちょろちょろと動く者
tel	〈名詞〉	鏡
carti	〈名詞〉	銀
klutan	〈名詞〉	具体的な値・定数
	〈名詞〉	金額・額面
lance	〈名詞〉	空
peisaa	〈名詞〉	靴
Bouns	〈名詞〉	兄
suel	〈名詞〉	隙間・隙
jasta	〈名詞〉	結末・終端・結局
	〈文頭詞〉	そして・終着にして・結局は
utykk	〈名詞〉	月
xalin	〈名詞〉	剣
Kirne	〈名詞〉	犬
lusko	〈名詞〉	肩・ショルｔダー
angastaCa	〈名詞〉	鍵
xarpasM	〈名詞〉	原住民・先住民
m'yero	〈名詞〉	源・源流・一切合切
	〈形容詞〉	源の・原始的な・合一的な
dijasi	〈名詞〉	玄関・門・入口・結界のほつれ
m'yesak	〈名詞〉	現界・源界
meantuks	〈名詞〉	言い訳
aulakk	〈名詞〉	言語
xece	〈名詞〉	言葉・文節・ことわざ
Kyz	〈名詞〉	限界・天井
genve	〈名詞〉	個性・個体
Cagenba	〈名詞〉	枯草
ty'ena	〈名詞〉	枯木・枯れ木
xal	〈名詞〉	虎
fena	〈名詞〉	後ろ
	〈形容詞〉	後ろの
icakal	〈名詞〉	語彙
icanak	〈名詞〉	語彙
tug	〈名詞〉	光
worty	〈名詞〉	口
nest	〈名詞〉	喉
Centerl	〈名詞〉	恒星
teinusgy	〈名詞〉	皇帝・王
kyen	〈名詞〉	硬貨
kasks	〈名詞〉	国家・政府
zey	〈名詞〉	恨む・忌む
geni	〈名詞〉	左
pegdi	〈名詞〉	妻・婚約者
mijen	〈名詞〉	罪・咎め・悪いこと
owiccu	〈名詞〉	作者
jolq	〈名詞〉	錯覚現象
	〈動詞〉	錯覚する・見間違う
tip	〈名詞〉	傘
awaCa	〈名詞〉	山・やま
am'ent	〈名詞〉	山・山岳
tioram'ent	〈名詞〉	山頂
avjant	〈名詞〉	山肌
kodon	〈名詞〉	酸素
Lens	〈名詞〉	姉
klestla	〈名詞〉	市民館・タウンホール・公民館
dery	〈名詞〉	指
tan'na	〈名詞〉	指導者・首領・首・頭
eliarl	〈名詞〉	紙
cein	〈名詞〉	紙幣
can'nak	〈名詞〉	試作品・偶然の産物
	〈形容詞〉	試しの・初号・試作の・洗練されていない
moa	〈名詞〉	事・抽象的なもの
Zenstin	〈名詞〉	事実・真実
jaq	〈名詞〉	時間
enis	〈名詞〉	耳
angzaypakCi	〈名詞〉	自動販売機
ickaZert	〈名詞〉	辞書・辞典・語彙書
Zark	〈名詞〉	辞典
angzoda	〈名詞〉	車・車両・自動車
momiccu	〈名詞〉	主・長・マスター
mekks	〈名詞〉	主張
olkos	〈名詞〉	守護・基地・総督府
derk	〈名詞〉	手
kopill	〈名詞〉	酒
knyb	〈名詞〉	首
xyys	〈名詞〉	呪い
anxe	〈名詞〉	秋
tikk	〈名詞〉	週
aynilin	〈名詞〉	銃
lampan	〈名詞〉	出帝・ランパン帝
	〈名詞〉	ランパン市
jelius	〈名詞〉	春
yiv	〈名詞〉	準備
Dunowl	〈名詞〉	準備する
lesven	〈名詞〉	順番・役目
lmur'a	〈名詞〉	女性
Keng	〈名詞〉	傷
p'eria	〈名詞〉	床
york	〈名詞〉	床
canu	〈名詞〉	消しゴム
eqCuw	〈名詞〉	消しゴム
xeymuks	〈名詞〉	証明
holoka	〈名詞〉	醤・出醤油
juki	〈名詞〉	上空・空の高いところ
calq	〈名詞〉	色
teylaga	〈名詞〉	食べられない物・非食部
teylo	〈名詞〉	食材・食べ物・可食部
keiZan	〈名詞〉	食事
xatt	〈名詞〉	心・精神
xenkahkonos	〈名詞〉	新幹線
t'ty'anly	〈名詞〉	森・森林
xanq	〈名詞〉	真理・真実
iQK	〈名詞〉	神
ag	〈名詞〉	人
teadan	〈名詞〉	人格・魂
calk	〈名詞〉	図形
xarK	〈名詞〉	水
siatex	〈名詞〉	水蒸気
geykty	〈名詞〉	水素
miccir	〈名詞〉	数・番号
micto	〈名詞〉	数学
esaki	〈名詞〉	世界
	〈形容詞〉	世界的な
escens	〈名詞〉	世界・この星・出星
	〈形容詞〉	地上の
terl	〈名詞〉	星
sdent	〈名詞〉	正解
enos	〈名詞〉	生物・動物
Neny	〈名詞〉	声
cilaw	〈名詞〉	青
adezin	〈名詞〉	石
egyq	〈名詞〉	責任
edain	〈名詞〉	赤色
Cyta	〈名詞〉	雪
cylanZa	〈名詞〉	雪川・雪河
Cydenva	〈名詞〉	雪崩
	〈動詞〉	雪崩が起こる
skrt	〈名詞〉	舌・口
tems	〈名詞〉	先端
	〈形容詞〉	尖った
ilanZa	〈名詞〉	川・河
yolanZa	〈名詞〉	川魚
geyta	〈名詞〉	戦争
vani	〈名詞〉	前
	〈形容詞〉	前の
ac'c	〈名詞〉	祖先・昔の人
ciks	〈名詞〉	僧
larixin	〈名詞〉	槍
enicia	〈名詞〉	窓
	〈動詞〉	窓を設ける
Qens	〈名詞〉	草・一年草
Canba	〈名詞〉	草・雑草・下草
akorg	〈名詞〉	造語
	〈動詞〉	造語する
eisaa	〈名詞〉	足
cerk	〈名詞〉	足・脚
	〈動詞〉	足蹴にする・蹴る
meisaa	〈名詞〉	足元・たもと
	〈副詞〉	足元に
bupl'azaz	〈名詞〉	足袋・たび・靴下
xonks	〈名詞〉	存在
xoqks	〈名詞〉	存在
neyTa	〈名詞〉	尊厳
ihuu	〈名詞〉	太陽
iZenme	〈名詞〉	大地・領地・人類界
edyrsu	〈名詞〉	大文字・正字
	〈形容詞〉	伝統的な・特別な
klben	〈名詞〉	炭素
siok	〈名詞〉	端・隅
	〈動詞〉	隅に追いやる・追い詰める
	〈前置詞〉	〜のすみ・〜の際
bcent	〈名詞〉	誕生日
mur'a	〈名詞〉	男性
banly	〈名詞〉	地面・(土の)床
aze	〈名詞〉	柱
Zeva	〈名詞〉	町
tiorx	〈名詞〉	頂・頂点・極大
beQsk	〈名詞〉	鳥
baQsk	〈名詞〉	鳥
basjanpa	〈名詞〉	鳥類
eryem	〈名詞〉	爪
tyga	〈名詞〉	定規
Bains	〈名詞〉	弟
naycia	〈名詞〉	鉄
qaksto	〈名詞〉	鉄
yent	〈名詞〉	点・中黒カンマ
amiadekorg	〈名詞〉	電気
elkoqy	〈名詞〉	電子・データ
	〈形容詞〉	電子上の・データ上の
xooban	〈名詞〉	土・土壌
meyi	〈名詞〉	土地・領地
guluks	〈名詞〉	怒りの
kels	〈名詞〉	冬
kelsament	〈名詞〉	冬山
ty'els	〈名詞〉	冬樹・冬木
Canbels	〈名詞〉	冬草
meQote	〈名詞〉	島・島嶼
osios	〈名詞〉	桃色・ピンク色
esia	〈名詞〉	答え
	〈文頭詞〉	応答の文頭詞
lakan	〈名詞〉	頭脳・かしこさ
ganZia	〈名詞〉	頭部・頭・頭蓋
yuuk	〈名詞〉	同好会・部・集団
gaga	〈名詞〉	道具・ツール
Cyekt	〈名詞〉	日
iclisk	〈名詞〉	日記・日誌
sylut	〈名詞〉	日付
monushaha	〈名詞〉	入浴行為
eqK	〈名詞〉	猫・ねこ・にゃんこ
loxxa	〈名詞〉	年
pes	〈名詞〉	白
	〈形容詞〉	白い
vexin	〈名詞〉	爆弾
Ciauna	〈名詞〉	箱・収納
meyiZo'rdU	〈名詞〉	畑・肥地・畑地
Zo'rdUban	〈名詞〉	畑土
zykac	〈名詞〉	発音線
cern	〈名詞〉	髪の毛
Keste	〈名詞〉	罰・代償・報酬
ajt	〈名詞〉	範囲・距離・射程
dyni	〈名詞〉	扉
jexxern	〈名詞〉	眉毛
etert	〈名詞〉	美術
eten	〈名詞〉	美術品
jenirt	〈名詞〉	美術品
nonk	〈名詞〉	鼻
melonk	〈名詞〉	鼻風邪
	〈動詞〉	鼻風邪を引く
jilni	〈名詞〉	筆箱
Ceniauna	〈名詞〉	筆箱
Lenvl	〈名詞〉	表
efitta	〈名詞〉	表意文字
akii	〈名詞〉	表情
	〈接尾辞〉	〜な顔
denC	〈名詞〉	病気・具合の悪さ
yuri	〈名詞〉	布
muska	〈名詞〉	布団・夜着
peyQ	〈名詞〉	父親
sogtt	〈名詞〉	負担
xin	〈名詞〉	武器
xinian	〈名詞〉	武器職人
Cie	〈名詞〉	部屋
cwa	〈名詞〉	部隊
jiks	〈名詞〉	風
mazalaaz	〈名詞〉	風・遺風・流儀・やり方
mel	〈名詞〉	風邪
won	〈名詞〉	覆う者
	〈動詞〉	覆い尽くす・(すっぽりと)覆う
konpein	〈名詞〉	物
twin	〈名詞〉	物
binstis	〈名詞〉	物語
issan	〈名詞〉	文学作品・小説
ltta	〈名詞〉	文字
lttenvel	〈名詞〉	文字表
shaud	〈名詞〉	文章・文
bykala	〈名詞〉	文明
varqm	〈名詞〉	文明・文化
ek'a	〈名詞〉	壁
malQ	〈名詞〉	母親
anzia	〈名詞〉	宝物・大事なもの
qye	〈名詞〉	方角・方向
	〈接尾辞〉	〜方・〜的傾向
kilqtt	〈名詞〉	法則・法
vuel	〈名詞〉	法律
	〈動詞〉	法に決める
vel	〈名詞〉	帽子・ヘルメット・装頭具
torpolink	〈名詞〉	望み・願い
	〈名詞〉	トーポリンク・望む事
entu	〈名詞〉	棒・(まっすぐな)線
end	〈名詞〉	頬・頬っぺた
kelqye	〈名詞〉	北・(比喩的に)冬
	〈形容詞〉	寒い・冬のような
brZert	〈名詞〉	本
iKott	〈名詞〉	魔物
amaiz	〈名詞〉	魔法
kolbi	〈名詞〉	麻
Leins	〈名詞〉	妹
orni	〈名詞〉	未来
Cloka	〈名詞〉	蜜柑・みかん
Tin	〈名詞〉	夢・望むこと・目標
myanCa	〈名詞〉	名前
qeyks	〈名詞〉	名前・銘
	〈動詞〉	呼ぶ・称する
sklas	〈名詞〉	明かり・灯
tleks	〈名詞〉	明日
olQes	〈名詞〉	面質
tyaqu	〈名詞〉	木・樹木・生木
yai	〈名詞〉	目・眼
abuul	〈名詞〉	夜
lasiks	〈名詞〉	役職・地位
kulaM	〈名詞〉	友人
onta	〈名詞〉	遊び
KnaKk	〈名詞〉	予定
yeyu	〈名詞〉	幼体・こども
tostikk	〈名詞〉	曜日
atyema	〈名詞〉	羊羹
jalon	〈名詞〉	硫黄
wattis	〈名詞〉	梁
itular	〈名詞〉	力・筋力
ed'ano	〈名詞〉	力・暴力
noka	〈名詞〉	林檎・りんご
Renf	〈名詞〉	涙・悲しみ・哀
apli	〈名詞〉	霊
palans	〈名詞〉	労働・仕事
sukatu	〈名詞〉	廊下・(機能的な)隙間
lazpen	〈名詞〉	和音
les	〈名詞〉	話・命題
tynva	〈名詞〉	惑星
	〈名詞〉	界隈・遠地
bcok	〈名詞〉	腕
adekorg	〈名詞〉	琥珀石
tenp	〈名詞〉	罠
yotyanos	〈名詞〉	蜥蜴・トカゲ・とかげ
manwo	〈名詞〉	蟲・昆虫・むし
