efmy	qrgp
iderni	qrgp
neyva	qrgp
owvos	qrgp
yerve	qrgp
aldeyn	qQr߁EVN̂
Cao	qQrVII
cayna	qQr낵E߂܂āEꂩ낵
Cirordo	qQrȂ
dag	qQrقEقE
dey	qQr
ea	qQr
eriy	qQrEno
iM	qQrBÊ
isea	qQr`Ȃ
jeni	qQrE͂Eyes
tein	qQr߁EʖڂE߂
walfy'ya	qQr͂悤
way'ya	qQrɂ
cyow	q^⎌r̂₤
erDi	q^⎌rړI₤^⎌EǂE
felio	q^⎌rꏊ₤^⎌EǂEǂ
hard	q^⎌rN?E?
igar	q^⎌r₤^⎌
lgy	q^⎌r₤
Reus	q^⎌r₤^⎌EǂEǂ
tuzi	q^⎌r`e₤
wels	q^⎌rR₤^⎌EȂEȂ
teavaqty	q`erȁÉׂEG
aCowi'r	q`erpꂽ
ady	q`erq̈
alekt	q`er`łȂ(ے)
alQe	q`er肦Ȃ
alrey	q`erꂽ
alte	q`erԖڂ́Eꓙ́E߂
antent	q`erʂ
arlslen	q`er
azqi	q`er̂悤
beanik	q`er
Cagna	q`er}S
cai	q`eŕE
can'nak	q`eŕEÉEĂȂ
canorir	q`er߂́Eڂƕ@̐
caqr	q`erȂ
Cayly	q`erP
Ceiti	q`erȒP
celuey	q`er؂₩
Ceniy	q`erYȁE
cieyni	q`erĂт
Cleq	q`er_ς
dey	q`er΂Eꂵ
deyny	q`er΂
Diqa	q`er
dyr	q`erZ
edinta	q`er^ԂȁE^g
edyrsu	q`er`IȁEʂ
elia	q`eȓ
elkoqy	q`erdq́Ef[^
enoks	q`eŕE
enta	q`er邳E
eriq	q`er̂܂܂́Eނo
esaki	q`erEI
escens	q`ern
essa	q`er
esse	q`er
far'e	q`er
fena	q`er
fipp	q`er疜
forett	q`erLȁEx߂Eɉh
fycw	q`eríEʂłȂ
fyl	q`erlԖڂ́El
gailen	q`er
geRks	q`erĜ悤
godir	q`er݂ȁEv̂܂܂
gordi	q`er傫
gulist	q`er{
hal	q`erE
helsten	q`erȉ́Eӂ
isse	q`eŕEƂE`
jenirt	q`erԂ́E
jeta	q`er̋
jorlisk	q`erO
jorq	q`erE
kalr	q`erZԖڂ́EZ
katty	q`er̂܂܂́E{
kelqye	q`erE~̂悤
KeQ	q`er()ÉE񂴂
KeRw	q`erǂ
klanh	q`erÉE炢
Kon	q`erʂ
korpu	q`er߂E߂
Kwikk	q`erLE\
kyla	q`erȂ
Kyyn	q`erEC̈
lalu	q`erB
lame	q`er
lana	q`eŕEۂ́E
lanjett	q`er󒆂
lant	q`erOԖڂ́EO
lapp	q`er\
lente	q`er̂悤
leyM	q`erixȂǂjEX̂
likka	q`er挱I
lisk	q`erO
lott	q`erlHIEsR
Luirt	q`erOԖڂ́E݂߂́EO
lyon	q`er́Esome
m'yero	q`eŕEnIȁEI
nel	q`er`ȂǁE
netu	q`er݂ڂ炵
olka	q`eri
oln	q`er߂́EȁE
onea	q`eroȂEs\
oRq	q`erǓƂ
osse	q`er
pag	q`er\
page	q`erS̓IȁESʂ
papa	q`erS
pes	q`er
piker	q`er㌱IȁE㔭
Qa	q`erԖڂ́E
qast	q`erz
qeta	q`erÂ
Ql	q`erԖڂ́E
riven	q`er{E͔͓I
Rlrd	q`erÂEÂE
sala	q`erԖڂ́E
segn	q`er
siatia	q`er
sin	q`er
sina	q`er
sipp	q`erꉭ
skirt	q`erԖڂ́Eӂ߂́E
tems	q`er
TeQ	q`er()ႢEቹ
teyntaq	q`erĂEX
tilbs	q`er厖ł͂ȂEsKv
tily	q`erE
tolt	q`erӖڂ́EȂ
trew	q`er`[vȁEۂ
ty'a	q`er́E(̓̂̒)
tywar	q`er^񒆂́E`
vani	q`erO
var	q`erܔԖڂ́E܂
vel'ed	q`er쐶
veliq	q`er@IȁE@ɒ߂ꂽ
vin	q`er
virKKat	q`eŕE[
vortlen	q`er㋉́Eʂ
vytel	q`erꂢȁE
waif	q`erꂽ
weeLuon	q`ersoEoԂɂ
wio	q`erR
wixa	q`erԖڂ́E
xelnik	q`erYȁE
xik	q`erE
xiy	q`erV
xleyn	q`er
xyk	q`er肵E܂
yeing	q`erY܂ꂽẮEc
yezqi	q`er̂悤
yula	q`er
Za	q`er\Ԗڂ́E\
zel	q`erԖڂ́E񓙂
zipp	q`erS
Zo'rdU	q`er삦
lea	qur`́EB`
tete	qur`̂悤
tritnia	qur`Ă܂
yit	qur`Ȃǂ
em(2)	qڑr`Ɓ`E&
emen	qڑrE`
enmecia	qڑr`Ɓ`E
eq'anu	qڑr`Ȃ
fain	qڑr``
haRo	qڑr`Ɓ`Ethat
lot	qڑr
peste	qڑr`ł`łE񓯎̐ڑ
peste	qڑr`łȂā`łE񓯎ٓ̐ڑ
rurz	qڑr`Ɣׂ
sai	qڑr`Ɠ`
sea	qڑr`ƁE΁EړIƂĂ̕
seyn	qڑr`E`Ƃ
vyuq	qڑr`̂悤
walir	qڑr`̂悤ȁE
a	qڔr`E
aca	qڔr`Ȑl
ain	qڔr`E
aj	qڔr`E
akii	qڔr`Ȋ
akt	qڔr`E
alpen	qڔr`ɂāE`ɑ΂
alu	qڔr`Ă炤Ev̐ڔ
aM	qڔr`lE`̐lX`̎
an	qڔr`E
ania	qڔr`EĂ܂EcO
art	qڔr`Eĥ̐ڔ
bakt	qڔr`NE`
ban	qڔr`yE`y
bef	qڔr`ER̊p
biz	qڔr`E]E]̐ڔ
ea	qڔr`ȂEے̊p
ed	qڔr`ā`EAp
ein	qڔr`ȁE֎~̐ڔ
ek	qڔr`E
el	qڔr`E󓮁Eg
ela	qڔr`
em	qڔr`n߂EJn
es	qڔr`ƂEo̊p
est	qڔr`ĂE˗
eta	qڔr`ĂE`Ƃ
ian	qڔrElE`
ink	qڔr`鎖E
ink	qڔr`E`e
iq	qڔr`Eߋ̐ڔ
i'r	qڔr`E]̐ڔ
is	qڔr`悤EU
jir	qڔr`̂悤ȁEE`e
jir	qڔr`炵E`Ɏ
keR	qڔr`
kint	qڔr҂
Kr	qڔr`̎ELEi̐ڔ
kyar	qڔrȂ́El̑i
lakr	qڔrȂ́El̑i
ly	qڔr`E`E
na	qڔr`EȋOu
of	qڔr`ṕEړI
ok	qڔr`ĂEi
ok	qڔr`ĂEp
ol	qڔr`ł傤E`łˁE`ȇh
on	qڔr`łE\̐ڔ
or	qڔr`낤E\z
oy	qڔr`Ă悢E
pa	qڔr`BE̐ڔ
piw	qڔr`E
Qen	qڔr`
qye	qڔr`E`IX
Ragi	qڔr`ҁE`
Rlrd	qڔr`EÂ`
ta	qڔr̐ڔ
tai	qڔr`E㉻EӁEcO̐ڔ
uks	qڔr`́E̐ڔ
un	qڔr`EړIi
uR	qڔr`ĂEis
us	qڔr`Eg̐ڔ
uxxe	qڔr`E
wo	qڔr`E
xel	qڔr`ׂE`
xyk	qڔr`ԖځE
yur	qڔr`ĂEɂis̐ڔ
albe	qOur`́Eabout
dlxa	qOur`ɂƂāE`ɉ
emenca	qOur`Ɓ`E
ererl	qOur`
et	qOur``܂
ete	qOur`̒
eype	qOur`ɂāE`ɑ΂
Ken	qOur`āE`ƁER
Kil	qOur`ɁE`x
lo	qOur`̂߂ɁEfor
lo	qOur(Ɉ)`ցE({Eނ̕\)`
luy	qOur`ȆOu
mi	qOur`̂
ot	qOur`ɁEinE
ped	qOur`
rib	qOurtoE`ɌāE`
rik	qOur`E`
sa	qOuronE`ɏ
siok	qOur`̂݁E`̍
stey	qOur`̖ڂ̑O
tang	qOur`΂
tia	qOur`́EofEE`
tun	qOur`ɉāE`̂܂܂
alte	q㖼rԖځEꓙ
asse	q㖼r
azqi	q㖼r
caixe	q㖼r̐l
caluk	q㖼r
cerla	q㖼rޏ
egqsse	q㖼rȂ̂
esse	q㖼r
haRo	q㖼r֌W㖼E`ȁ`Ƃ
inqsse	q㖼rLۖ
isse	q㖼rEƂ́E`̂E
lar	q㖼rށEޏEޓz
lay	q㖼rlE
lente	q㖼rȎE
lirse	q㖼r
niy'yei	q㖼rNE
osse	q㖼r
Qaise	q㖼rNElƂā`Ȃ
Qeince	q㖼rNEN
qursse	q㖼rNEN
tew	q㖼rMENE
we	q㖼rEE킽
wey	q㖼r(^NV)
Xine	q㖼rE(ww)
yenk	q㖼rzEEɂ
yezqi	q㖼r
yuta	q㖼r
zel	q㖼rԖځE
cykk	qPʁr
delk	qPʁrfN
eCrgin	qPʁriKEtF[YE
iZd	qPʁro[WEiK
kni	qPʁr`O
kukk	qPʁr
kxe	qPʁr`
nakk	qPʁr
qr'a	qPʁrj[A
vakk	qPʁrb
xakk	qPʁr
Zua	qPʁr`
Kai	qrhE(т)E`
aber	qr΂E}
aCown	qrp
adelni	qrΑł
aguli	qrꐡɂE
akac	qrςEω
akacoln	qr
akCaq	qr~E
akcIno	qrXVE߂
aken	qrlEN
aklas	qr炭
aklenz	qr
akorg	qrꂷ
alged	qr(\͂Ȃǂ)󂯂
alke	qrƂ
alrtai	qrꂽ
amunow	qrJ
antent	qrʂ
aritto	qr~܂E~
arqs	qrv
attyela	qr`eEC
ayein	qrEZ
ayn	qr˂
azapes	qrE
banQal	qrȂƂɂEE폜
banTin	qr`̂ӂ
befise	qrɂȂEグE߂
belni	qr
bens	qr(ԓ)U
bermo	qrUEU炩
bey	qr
caow	qr
car	qrݏo
cef	qr߂EƊϑ
cekten	qr
Cente	qrP
cerk	qrRɂER
Ceyka	qrĂEz
Cgy	qrY
Cilon	qrłڂE
cily	qrEn
cirj	qrvZ
Cxin	qr̂
Cydenva	qrN
Cygena	qr͂EႪȂȂ
cyp	qri
danbi	qrt炤Eڂ
dent'ail	qrȂȂ
denva	qr
derkente	qrȂ
dey	qr
deytam	qr
deytor	qrj
Diko	qr@EłE
Diwemo	qrhE(ӂȂĐ)nŎh
dort	qr
edylot	qrE
efty	qrӖ
ekatt	qr
elence	qrׂ
elence	qr|E|Z
elib	qro
elq'o	qr݂
emen	qrEZ
enaulu	qrĂ炤
enest	qr`
enia	qr
enicia	qr݂
entiv	qrK
esiaty	qr
esscl	qrڂE|
etyskks	qrB
fecy	qr\tEڒ
fiexx	qr`Ƃ݂
Fladus	qr@oE@
fog	qrE`
font	qrEB
fuo	qr
fwel	qrEĂ炤
gena	qr͂
genQ	qrHEEւ
goda	qr߂E]
goon	qr~E~
gr'rin	qr`
grus	qrDED
gulain	qr{
hae	qrEE()܂
hakkum	qrEZʂEt
hayl	qr҂\E荞
hekum	qrႤEv
helka	qrEL
hwote	qr
hyurZa	qrEE킮E(lȂǂ)̂
icalur	qraEؒfE
iclas	qrLEL^
icno	qrvE傫ςElςEł|
iM	qrm
iprii	qr
isea	qr]܂Ȃ
iyenmi	qrExeEقƂ
jelen	qrfE؂
jeni	qrEEȉ
jent	qr
jes	qr؂
jestin	qrESOEvƂǂ܂
jeta	qr
jolq	qroEԈႤ
jrq	qr
Katain	qrR
Kenir	qrʂEԂY
Kenxy	qrقEӂ߂E梐ӂEӂ
Kery	qrEsE
Kgyw	qrJ
klant	qri߂
klse	qro
kor'ey	qriށEiR
ktor	qrE܂𗬂
kuliuM	qr͂
kyenin	qrRCgXEqɂČ߂
lary	qr˂EՂ
las	qrEׂE`Ƃ
leyz	qr]E
lfela	qr
lot	qr`́Ebe
luku	qr
maace	qrEe
maynor	qrx
meantam	qr
melonk	qr@ׂ
meluain	qrׂЂ
messe	qr咣
meti	qr(l)ZE
meyli	qrEHE藎
Nako	qr͂
nanta	qrEL
nasM	qrJԂE
nasvel	qr
neeq	qrcEpE(̏ɂȂƂ)eyڂ
nord	qrk
noupw	qr
oKnak	qr
olnin	qrM
ons	qrk
oRga	qrL^
oRo	qrsEsRE
oz'ak	qr
pal	qrJ
pos	qru
Qazin	qr@E@Ƃ
qem	qrY܂E܂Ea
qio	qrE݂EE݂
reyla	qr]E̓_
Satis	qrς
satis	qrς
sent	qr
sianti	qr
siataa	qrsEށEЂ
si'ja	qr
sinlaxx	qrN
siok	qrɒǂEǂl߂
sites	qrȂȂE
skrlin	qrEbEGk
skr'ro	qrقE
stey'yen	qr߂
suoh	qr~߂E߂
swonk	qrMEMp
tante	qrqEAEт
tawor	qrB
tia	qr`ɏE`ɂ
Ton	qr݂
torpol	qr]ށE~Eؖ]
tuel	qr
tuk	qr]
tuRo	qrg
tweek	qr
two	qrEsEDo
tyfal	qrKvɂȂ
tylrx	qrG
tyxen	qr키
ukRe	qrE
vaxi	qr(ƂȂǂ)A
velin	qrɏ悹E(XqȂǂ)Ԃ
vely	qr(̈ӂ)j󂷂E
veqa	qr
verent	qrj
vote	qrx
vote	qr
vuel	qr@Ɍ߂
waif	qr
wal	qr`
webens	qrI
weera	qrsEEDo
wenks	qre
wirt	qr
wog	qrEE삷
won	qrsE(ۂ)
worp	qrE݌삷Eی삷EB
xaenk	qrEoEo
xale	qra
xarlo	qrn܂En߂
xeymeaQ	qrؖE[
xik	qr
xinks	qro肷
xrdi	qrHׂ
xyk	qr肷
yaldia	qrEȂт
yed	qr
yeinad	qr
yelda	qr
yurkeim	qr̂
Zank	qr`̑΂ɂȂE΂ɐ
Zanta	qrEO
Zbeft	qrT
Zijtes	qrE(̈ӂ)čs
Zikka	qrƂ
ZofKo	qrʂEE
Zofte	qrEo
Zorne	qrΉE(Έ)т
zyka	qrEǂ
akku	qrߋ
akozitt	qrmɁEԈႢȂ
azqi	qr̂悤
canor	qr΂ɁE߂
canorir	qr߂ɁB΂ɁE҂߂
Ceaks	qr
far'e	qrɁE`܂
felir	qrƂĂ
godir	qr݂ɁEv̂܂܂ɁE]ނ܂܂
henpty'a	qrZkāEȌ
illa	qr
ilyan	qrX
jar	qr́E
jorTikk	qr߂
katty	qr̂܂܁E
kaws	qr
KeQ	qrE
lagey	qr܂EĂсEēx
lea	qr`݂̂E`
lente	qr̂悤
lova	qrƂĂ
meisaa	qr
myeise	qrāECɂ
myjot	qr{CŁE^ɁEkłȂ
nalia	qrƁEX
osni	qrŁE
page	qrS̓IɁBSʓI
pal'an	qrƂɁEłɁEƑO
pay	qrEイ
pirgekks	qr
segnq'a	qrE
segta	qr
siatip	qrPɂE݌쉺
sRlen	qr낻EȂ
stey	qr`̖ڂ̑O
teavaqty	qrɁEׂ
TeQ	qrႭEቹ
tliakks	qr
tolt	qrT
ty'akks	qr
wiot	qrRɁEՂ
wis	qrE
yekk	qr̓E̎
yezqi	qrȂ
bale	qr
bey	qr`ȂEif
enca	qrӊOƁEĊO
eriy	qrEł͂E΂Ƃ
esia	qr
hel	qr^̕
kap	qr``낤
kaste	qr`炵ƕ
kix	qr`łE
luen	qrԂE炭E
pniaCa	qr`ȂEif
selcw	qrb͕ς邪EE
seyn	qr̎
venial	qr`ƂĂE
ZalaK	qr肵ẮE܂
abuul	qr
ac'c	qrcÊ̐l
adelni	qrΑł
adezin	qr
ag	qrl
akii	qr\
akku	qrߋEo
aklante	qrMhEƎҏWcE
akluks	qr
akorg	qr
alley	qrlY~El
alte	qrA
amaiz	qr@
am'ent	qrRERx
anxe	qrH
apli	qr
asikk	qrXv[E
asse	qr
atyema	qrr
aulakk	qr
avjant	qrR
aynilin	qre
aze	qr
Bains	qr
banly	qrnʁE(y)
bcent	qra
belto	qrB
Bouns	qrZ
brZert	qr{
bykala	qr
cadi	qr
Cagenba	qr͑
calk	qr}`
calq	qrF
Canba	qrEGE
Canbels	qr~
can'nak	qriER̎Y
canu	qrS
caq	qrC
carti	qr
cein	qr
Cel	qrVFEo
Ceniauna	qrM
Centerl	qrP
cerk	qr
cern	qr̖
ceyM	qry
ceyZaM	qrfB[E
Ciauna	qrE[
Cie	qr
ciks	qrm
cilaw	qr
Cloka	qr
Coltk	qr(̏ł)
cwa	qr
Cydenva	qr
Cyekt	qr
cykk	qr
cylanZa	qrE
Cyta	qr
derk	qr
derl	qrD
deR'onta	qrĂق
dery	qrw
doles	qr.EE
Dunowl	qr
edain	qr
ed'ano	qŕE\
edyrsu	qr啶E
efitta	qr\ӕ
efty	qrӖ
egyq	qrӔC
eisaa	qr
ek'a	qr
elhest	qrwE
eliarl	qr
elkoqy	qrdqEf[^
elto	qrE
ely	qr0
end	qrjEj؂
eni	qry
enicia	qr
enoks	qrE
eqCuw	qrS
eqK	qrL
eryem	qr
esaki	qrE
escens	qrEE̐Eo
eten	qrpi
etert	qrp
evorle	qrl
fena	qr
fin	qr100ES
fipp	qr10000000E疜
fisto	qrF
funi	qr
fyl	qr4El
geni	qr
genve	qrE
geykty	qrf
geyta	qr푈
gles	qr!!
gosten	qrG
guluks	qr{
hal	qrE
heles	qr?E^̕EE^╄
hist	qrH
icakal	qrb
icanak	qrb
icno	qrv
ifoll	qrꗗE\
ihuu	qrz
iKott	qr
ilanZa	qrE
ilto	qrI
inqsse	qrϏOȆ吨
iQK	qr_
issan	qrwiE
itular	qŕEؗ
iZenme	qrnE̒nElފE
jalon	qr
jaq	qr
jelius	qrt
jenirt	qrpi
jerte	qrJ
jerxe	qrEE
jie	qr0.0001Eꎅ
jiks	qr
jilni	qrM
jolq	qro
jor'laM	qrER̎
juki	qrE̍Ƃ
Kai	qrCNEn`
kalr	qr6EZ
kanam	qro[EE
karon	qrK
kasks	qrƁE{
Kat	qrR
kelqye	qrkE(gI)~
kels	qr~
kelsament	qr~R
Keng	qr
Keste	qrE㏞EV
kilqtt	qr@E@
Kirne	qr
klben	qrYf
klutan	qr̓IȒlE萔
klutan	qrzEz
KnaKk	qr\
knyb	qr
kodon	qr_f
kolbens	qrLoX
kolbi	qr
Komitto	qr
konpein	qr
kopill	qr
kpolla	qr()ʕ
kukk	qrꎞ
kulaM	qrFl
kyen	qrd
Kyz	qrEEV
lame	qr10000E
lance	qr
lant	qr3EO
lapp	qr1000000000E\
larixin	qr
lazpen	qra
Leins	qr
Lens	qro
Lenvl	qr\
les	qrbE
lesven	qrԁE
Linkty	qr`E
lisZelt	qrm[gEE蒠
lmbyaadeyn	qr[
lmur'a	qr
lnsa	qr
loxxa	qrN
lt	qrL
ltta	qr
lttenvel	qr\
lulto	qrL
malQ	qre
mea	qrE}En
mea	qrIIlY~
meantuks	qr
meisaa	qrE
mekks	qr咣
mel	qr
melonk	qr@
menitin	qr}OlVE
mesty	qrM
meyi	qrynE̒n
meyiZo'rdU	qrEnEn
meyZal	qrYE
miccir	qrEԍ
mie	qr0.01E
mije	qr0.0000000001Eꈥ
mime	qr0.000000001Eo
miria	qr0.00000001Eꍹ
miTe	qr0.0000001E@
mixx	qr0.000001E
miye	qr0.00000000001Eꑪ
moa	qrEۓIȂ
mur'a	qrj
m'yero	qrEE؍
m'yesak	qrEEE
naycia	qrS
nayuto	qrN
nel	qrFȄ̑S
Nels	qr
Neny	qr
nest	qrA
neyTa	qr
noka	qrьE
nonk	qr@
oln	qr0E[EEE
olNes	qr
olnin	qrM
olQes	qrʎ
olto	qrO
onta	qrV
orni	qr
owiccu	qr
pag	qr100000E\
papa	qr10000000000ES
pegdi	qrȁE
p'eria	qr
pes	qr
pesto	qrP
peyQ	qre
possikt	qr`ƐEu
Qa	qr9E
qaksto	qrS
Qanto	qrQ
Qea	qrԈႢE~X
Qens	qrEN
qeyks	qrOE
Ql	qr2E
qr'a	qrj[A
qye	qrpE
raiten	qrE
rast	qrR
reiben	qr(I)DƂC
Renf	qr܁E߂݁E
ria	qr0.01E
riven'agi	qr(͔͂ƂȂ)l
Sabqtt	qrV[o̒u耖@EV[oEV[o
sala	qr7E
san	qrS
sdent	qr
shaud	qŕE
siatip	qrP̂́E݌쉺̂́E
siatto	qr
sin	qr1000E
siok	qr[E
sipp	qr100000000E
skrt	qrE
sogtt	qrS
suel	qrԁE
sylut	qrt
taylo	qrHׂȂEH
Te	qr0.1Eꕪ
teadan	qrliE
tel	qr
tems	qr[
tenp	qr
terl	qr
teye	qr0.00001Eꍚ
teylo	qrHוEH
tikk	qrT
Tin	qrE]ނƁEڕW
tioram'ent	qrR
tiorx	qrE_
tist	qrT
tivloxxa	qr邤NE[N
tleks	qr
tostikk	qrj
tug	qr
twin	qr
ty'a	qr1EE
tyaqu	qr؁E؁E
ty'els	qr~E~
ty'ena	qr͖؁E͂
tyga	qrK
tywar	qrSE
uens	qrOEmʂƂ
ulto	qrU
utykk	qr
vala	qr`̗
valM	qrV
valtin	qrxE
vani	qrO
var	qr5E
varqm	qrE
vel	qrXqEwbgE
vexin	qre
vuel	qr@
wattis	qr
weelin	qrׂ
wixa	qr8E
wla	qrW
won	qr
worty	qr
xakk	qr΁ENEgV
xal	qr
xalin	qr
xanq	qr^E^
xarK	qr
xatt	qrSE_
xayl	qr|
xece	qrtE߁EƂ킴
xesten	qrX
xeymuks	qrؖ
xin	qr
xinian	qrEl
xonks	qr
xooban	qry
xoqks	qr
xyys	qr
yai	qrځE
yalto	qrY
yeljetto	qr
yent	qr_E
yente	qr
yiv	qr
york	qr
yuri	qrz
Za	qr10E\
Zark	qrT
zel	qrZEz
Zenstin	qrE^
Zeva	qr
zey	qrށE
zipp	qr1000000ES
Zo'rdUban	qry
zykac	qr
